0110 0111 01010000 01000001 01001100 01000001 01010110 01010010 01000001 01000011 01001111 01001110 01010100 01000101 01011000 01010100 01001111
0111 1100 01000001 01010100 01001001 01010100 01010101 01000100 01000101 01010011 01000011 01001111 01001101 01010000 01001111 01010010 01010100 01000001 01001101 01000101 01001110 01010100 01001111
0111 0110 01001110 01000101 01000111 01001111 01000011 01001001 01001111 01010011 01000101 01001101 01010000 01010010 01000101 01010011 01000001
0111 0111 01010011 01001111 01001100 01010101 01000011 01001111 01000101 01010011 01010010 01000101 01010011 01010000 01001111 01010011 01010100 01000001
0111 1010 01000101 01010110 01001111 01001100 01010101 01000011 01000001 01001111 01000011 01010010 01000101 01010011 01000011 01001001 01001101 01000101 01001110 01010100 01001111
0111 1001 01010010 01000101 01000011 01010101 01010010 01010011 01001111 01010011 01000100 01001001 01010011 01010000 01001111 01001110 01001001 01010110 01000101 01001100
0111 0110 01000100 01000101 01000011 01001001 01010011 01001111 01000101 01010011 01000101 01010011 01000011 01001111 01001100 01001000 01000001
0111 1000 01000101 01000110 01001001 01000011 01000001 01000011 01001001 01000001 01010010 01000101 01010011 01010101 01001100 01010100 01000001 01000100 01001111
0111 1000 01000100 01000101 01010011 01000001 01000110 01001001 01001111 01010011 01001111 01000010 01010011 01010100 01000001 01000011 01010101 01001100 01001111
1000 0111 01001101 01001111 01010100 01001001 01010110 01000001 01000011 01000001 01001111 01000101 01010011 01010100 01001001 01001101 01010101 01001100 01001111
1000 0111 01001001 01001110 01001111 01010110 01000001 01000011 01001111 01000101 01010011 01001110 01001111 01010110 01001001 01000100 01000001 01000100 01000101
1000 0111 01001100 01001001 01000100 01000101 01010010 01000001 01001110 01000011 01000001 01000011 01001111 01001110 01000100 01010101 01000011 01000001 01001111
1000 0111 01010011 01000101 01000111 01010101 01010010 01000001 01001110 01000011 01000001 01010000 01010010 01001111 01010100 01000101 01000011 01000001 01001111
1000 0110 01000011 01001111 01001110 01010001 01010101 01001001 01010011 01010100 01000001 01010011 01010101 01000011 01000101 01010011 01010011 01001111
1000 0100 01010000 01010010 01001111 01000011 01000101 01010011 01010011 01001111 01010011 01000110 01001100 01010101 01011000 01001111
1000 1010 01000001 01010110 01000001 01001110 01000011 01000001 01000100 01001111 01010011 01010011 01001111 01000110 01001001 01010011 01010100 01001001 01000011 01000001 01000100 01001111
1000 1001 01010001 01010101 01000001 01001100 01001001 01000100 01000001 01000100 01000101 01000101 01011000 01000011 01000101 01001100 01000101 01001110 01000011 01001001 01000001
1000 1000 01000011 01001111 01001110 01000011 01001100 01010101 01010011 01000001 01001111 01010010 01000101 01010011 01001111 01001100 01010101 01000011 01000001 01001111
1000 1010 01010000 01010010 01001111 01000010 01001100 01000101 01001101 01000001 01010011 01000100 01001001 01000110 01001001 01000011 01010101 01001100 01000100 01000001 01000100 01000101
1000 0011 01001111 01000010 01001010 01000101 01010100 01001001 01010110 01001111 01010011 01001101 01000101 01010100 01000001
1001 1100 01010011 01000001 01010100 01001001 01010011 01000110 01000001 01000011 01000001 01001111 01000011 01001111 01001110 01010100 01000101 01001110 01010100 01000001 01001101 01000101 01001110 01010100 01001111
1001 1010 01000001 01010110 01000001 01001100 01001001 01000001 01000011 01001111 01000101 01010011 01010110 01000101 01010010 01001001 01000110 01001001 01000011 01000001 01000011 01000001 01001111
1001 0110 01000011 01001111 01001110 01010001 01010101 01001001 01010011 01010100 01000001 01010011 01010110 01001001 01010100 01001111 01010010 01001001 01000001
1001 1011 01010010 01000101 01010011 01010101 01001100 01010100 01000001 01000100 01001111 01010011 01000011 01001111 01001110 01010011 01000101 01010001 01010101 01000101 01001110 01000011 01001001 01000001
1001 0110 01010000 01001100 01000001 01010100 01000001 01000110 01001111 01010010 01001101 01000001 01010011 01001001 01010011 01010100 01000101 01001101 01000001
1001 1100 01000101 01000110 01001001 01000011 01001001 01000101 01001110 01000011 01001001 01000001 01010000 01010010 01001111 01000100 01010101 01010100 01001001 01010110 01001001 01000100 01000001 01000100 01000101
1001 0011 01000101 01010011 01010100 01010010 01010101 01010100 01010101 01010010 01000001 01010011 01000010 01000001 01010011 01000101
1001 1000 01010010 01000101 01001110 01000100 01001001 01001101 01000101 01001110 01010100 01001111 01010010 01000101 01010011 01010101 01001100 01010100 01000001 01000100 01001111
1001 0100 01000101 01010011 01010100 01010010 01000001 01010100 01000101 01000111 01001001 01000001 01010000 01001100 01000001 01001110 01001111
1010 1000 01000011 01001111 01001101 01010101 01001110 01001001 01000011 01000001 01000011 01000001 01001111 01001001 01001110 01010100 01000101 01010010 01000001 01000011 01000001 01001111
1010 1010 01000011 01001111 01001101 01010101 01001110 01001001 01000100 01000001 01000100 01000101 01010011 01000011 01001111 01001110 01010110 01001001 01010110 01000101 01001110 01000011 01001001 01000001
1010 1001 01000011 01001111 01001111 01010010 01000100 01000101 01001110 01000001 01000011 01000001 01001111 01001001 01001110 01010100 01000101 01000111 01010010 01000001 01000011 01000001 01001111
1010 0100 01001001 01001110 01000110 01001111 01010010 01001101 01000001 01000011 01001111 01000101 01010011 01000100 01000001 01000100 01001111 01010011
1010 0011 01001001 01001110 01001001 01000011 01001001 01000001 01010100 01001001 01010110 01000001 01010011 01000001 01000011 01000001 01001111
1010 1101 01001110 01000101 01000011 01000101 01010011 01010011 01000001 01010010 01001001 01001111 01010011 01001001 01001101 01010000 01010010 01000101 01010011 01000011 01001001 01001110 01000100 01001001 01010110 01000101 01001100
1010 1000 01001001 01001101 01010000 01001111 01010010 01010100 01000001 01001110 01010100 01000101 01010011 01010010 01000101 01001100 01000101 01010110 01000001 01001110 01010100 01000101
1010 0111 01001101 01000101 01010100 01001111 01000100 01001111 01001100 01001111 01000111 01001001 01000001 01010000 01010010 01001111 01000011 01000101 01010011 01010011 01001111
1010 1010 01010100 01000101 01000011 01001110 01001111 01001100 01001111 01000111 01001001 01000001 01010011 01001101 01001111 01000100 01000101 01010010 01001110 01001001 01000100 01000001 01000100 01000101
1010 1010 01001000 01000001 01000010 01001001 01001100 01001001 01000100 01000001 01000100 01000101 01010011 01000011 01001111 01001101 01010000 01000101 01010100 01000101 01001110 01000011 01001001 01000001
1010 1011 01000101 01010011 01010100 01010010 01000001 01010100 11001001 01000111 01001001 01000001 01010011 01010000 01001100 01000001 01001110 01000101 01001010 01000001 01001101 01000101 01001110 01010100 01001111
1010 0111 01001001 01001101 01010000 01001100 01000101 01001101 01000101 01001110 01010100 01000001 01010010 01000101 01011000 01000101 01000011 01010101 01010100 01000001 01010010
1011 0101 01000001 01001100 01010100 01000101 01010010 01001110 01000001 01010100 01001001 01010110 01000001 01010011 01001111 01010000 01000011 01001111 01000101 01010011
1011 1010 01001111 01010010 01000111 01000001 01001110 01001001 01011010 01000001 01000011 01001111 01000101 01010011 01000101 01001101 01010000 01010010 01000101 01010011 01000001 01010010 01001001 01000001 01001100
1011 1010 01010000 01001100 01000001 01001110 01000101 01001010 01000001 01001101 01000101 01001110 01010100 01001111 01000101 01010011 01010100 01010010 01000001 01010100 01000101 01000111 01001001 01000011 01001111
1011 1001 01000011 01001111 01001101 01010000 01010101 01010100 01000001 01000100 01001111 01010010 01000101 01010011 01010100 01000101 01000011 01001110 01001111 01001100 01001111 01000111 01001001 01000001
1011 0100 01010000 01000101 01010010 01010011 01010000 01000101 01000011 01010100 01001001 01010110 01000001 01010011 01010110 01001001 01010011 01000001 01001111
1011 1000 01000110 01010101 01001110 01000100 01000001 01001101 01000101 01001110 01010100 01000001 01001001 01010011 01000101 01010011 01010011 01000101 01001110 01000011 01001001 01000001 01001100
1011 0111 01000101 01011000 01010000 01000101 01010010 01001001 01000101 01001110 01000011 01001001 01000001 01010011 01010110 01001001 01010110 01000101 01001110 01000011 01001001 01000001
1100 1010 01010000 01000001 01010010 01010100 01001001 01000011 01001001 01010000 01000001 01000011 01001111 01000101 01010011 01000101 01001110 01000111 01000001 01001010 01000001 01001101 01000101 01001110 01010100 01001111
1100 1100 01001111 01010000 01001111 01010010 01010100 01010101 01001110 01001001 01000100 01000001 01000100 01000101 01010011 01000110 01000001 01010110 01001111 01010010 01000101 01000011 01001001 01001101 01000101 01001110 01010100 01001111
1100 1011 01000011 01001111 01001100 01000001 01000010 01001111 01010010 01000001 01000100 01001111 01010010 01000101 01010011 01010000 01010010 01001111 01000110 01001001 01010011 01010011 01001001 01001111 01001110 01000001 01001100
1100 1000 01000011 01001111 01001110 01001000 01000101 01000011 01001001 01001101 01000101 01001110 01010100 01001111 01010011 01010011 01000001 01000010 01000101 01000100 01001111 01010010 01001001 01000001
1100 1001 01001001 01001110 01010110 01000101 01010011 01010100 01001001 01001101 01000101 01001110 01010100 01001111 01010011 01000110 01001001 01001110 01000001 01001110 01000011 01000101 01001001 01010010 01001111
1100 1100 01000111 01000101 01010010 01000101 01001110 01000011 01001001 01000001 01001101 01000101 01001110 01010100 01001111 01000001 01000100 01001101 01001001 01001110 01001001 01010011 01010100 01010010 01000001 01000011 01000001 01001111
1100 1010 01010000 01010010 01001111 01000011 01000101 01000100 01001001 01001101 01000101 01001110 01010100 01001111 01010011 01010011 01001001 01010011 01010100 01000101 01001101 01000001 01010100 01001001 01000011 01001111
1100 1001 01001101 01000101 01001100 01001000 01001111 01010010 01000001 01001101 01000101 01001110 01010100 01001111 01010011 01001111 01010100 01001001 01001101 01001001 01011010 01000001 01000011 01000001 01001111
1101 1010 01001001 01001110 01000110 01010010 01000001 01000101 01010011 01010100 01010010 01010101 01010100 01010101 01010010 01000001 01010011 01010101 01010011 01010100 01000101 01001110 01010100 01000001 01000011 01000001 01001111
1101 1010 01010000 01001111 01010011 01010011 01001001 01000010 01001001 01001100 01001001 01000100 01000001 01000100 01000101 01010011 01010110 01001001 01000001 01000010 01001001 01001100 01001001 01000100 01000001 01000100 01000101
1110 1010 01000100 01000101 01010011 01000101 01001110 01010110 01001111 01001100 01010110 01001001 01001101 01000101 01001110 01010100 01001111 01001000 01010101 01001101 01000001 01001110 01001001 01010100 01000001 01010010 01001001 01001111
1110 0111 01000100 01000101 01010011 01000101 01001110 01010110 01001111 01001100 01010110 01001001 01001101 01000101 01001110 01010100 01001111 01000101 01010110 01001111 01001100 01010101 01000011 01000001 01001111
1110 1010 01000011 01001111 01001110 01010011 01000011 01001001 01000101 01001110 01010100 01001001 01011010 01000001 01000011 01000001 01001111 01001001 01001110 01000110 01001111 01010010 01001101 01000001 01010100 01001001 01010110 01001111
1111 1000 01010011 01010101 01010011 01010100 01000101 01001110 01010100 01000001 01000010 01001001 01001100 01001001 01000100 01000001 01000100 01000101 01000101 01000011 01001111 01001100 01001111 01000111 01001001 01000011 01001111
1111 1010 01010010 01000101 01010011 01010000 01001111 01001110 01010011 01000001 01000010 01001001 01001100 01001001 01000100 01000001 01000100 01000101 01000011 01001111 01001101 01010000 01010010 01001111 01001101 01001001 01010011 01010011 01001111
1111 0110 01010100 01000101 01001100 01000101 01000011 01001111 01001101 01010101 01001110 01001001 01000011 01000001 01000011 01001111 01000101 01010011 01000011 01001111 01001110 01000101 01011000 01000001 01001111